NO ./textures/diamond_ore.xpm
SO ./textures/stone.xpm
WE ./textures/stone.xpm
EA ./textures/stone.xpm
NO ./textures/texture4.xpm
SO ./textures/texture4.xpm
WE ./textures/texture4.xpm
EA ./textures/texture4.xpm

F 120,100,185
C 52,77,66

1111111111111
1000000000001
1000000200001
10001000P0001
1000000000001
1111111111111
