NO ./textures/diamond_ore.xpm
SO ./textures/stone.xpm
EA ./textures/stone.xpm

WE ./textures/stone.xpm



F 120,100,185
C 52,77,66






1111111111111
1000000000001
1000000200001
100010000001
1000000S00001
1111111111111
