NO ./textures/texture1.xpm
SO ./textures/texture2.xpm
WE ./textures/texture3.xpm
EA ./textures/texture4.xpm
NO ./textures/texture4.xpm
SO ./textures/texture4.xpm
WE ./textures/texture4.xpm
EA ./textures/texture4.xpm

F 220,100,0
C 225,30,0

1111111111111
1000000000001
1000000200001
1000100000001
1000000000001
1111111111111
