
C 225,30,0


EA ./textures/texture1.xpm

SO          ./textures/stone.xpm
WE ./textures/stone.xpm
NO ./textures/diamond_ore.xpm

F 0   , -100,0


        1111111111111111111111111
        1000000000110000000000001
        1011000001110000000000001
        100100000000000000000N001
111111111011000001110000000000001
100000000011000001110111111111111
11110111111111011100000010001
11110111111111011101010010001
11000000110101011100020010001
10000000000000001100000010001
1000000000000000110101000001
1100000111010101111101111000111
11110111 1110101 101111010001
11111111 1111111 111111111111